1111111111111111111111111111111111
10000000000000000000000000000000E1
1010010100100000101001000000010101
1010010010101010001001000000010101
1P00000000000000000000000C00000001
1111111111111111111111111111111111
