111111111111111111111111111111
100100010000000000000000000001
101110010000000100001111111111
100000010010011111000000000011
100000010010000000000000000001
100000010010000000111110000001
100100011110000000100100000001
100100000000000001100111110001
100100000000010011110000000001
100100000000010011111100000001
10010011100001000000111111001
100100001011100001100000001001
100111111000100001000000001001
11010011000000001000111111001
111100110000100001000001000001
100100000000100P01000001000001
100100001111111111111111100001
100100000100000100000000000001
100000110000001100000000000001
10011111001100011111111111001
1000001100110000000000000000E1
111111111111111111111111111111
