11111111111111111111
10000000000000000001
10111111111111110011
10100000000000100101
1010111011110101001
10101000000010100101
10101011111110101001
10101010000000100101
10001010111110101001
101010100P0010100101
10101011111110101001
10101000000010100101
10101111111110101001
10100000000000100101
10111111111111110001
10000000000000011
11111111111111111111
